Key - RoomI
W=PlatformArchetype,true
H=EricLevels\Level4\roomswitchs\RoomSwitch18To17,false
G=EricLevels\Level4\roomswitchs\GoalBlock,false
,
LAYOUT: 18x10
........H.........
WWWWW........WWWWW
WWWWWW........WWWW
WWWWW........WWWWW
WWWWWW........WWWW
WWWWW........WWWWW
WWWWWW......WWWWWW
WWWWWWWGGGGWWWWWWW
WWWWWWWGGGGWWWWWWW
WWWWWWWGGGGWWWWWWW
WWWWWWWWWWWWWWWWWW
,
